#######################################
#.........#...........................#
#.........#...........................#
#...............#.....#.#...#.###.....#
#....#.#..........................##..#
#...........................##........#
#....#....##.#...#...........#........#
#.........#.....#......##.............#
#.........#...#..#......##...#..####..#
#.........#..#...##......##...........#
####...####...........##.....#........#
#...........#..#...##.........#.......#
#.............................#.......#
#..#......##......##...###....#...##..#
#...#.....#........##.........#.......#
#....#....#...#...............#.......#
#.....#...#..........##..##.###..###..#
#......#..#....##.............#.......#
#.......#.#........###........#.......#
#.....................................#
#######################################















